R 1280 720
NO ./textures/north.xpm
SO ./textures/south.xpm
WE ./textures/west.xpm
EA ./textures/east.xpm

S ./textures/pillar.xpm
C 1,120, 200
F 128,100,128

111111
120101
102001
1100N1
111111
